NO ./assets/textures/north.xpm
SO ./assets/textures/south.xpm
WE ./assets/textures/west.xpm
EA ./assets/textures/east.xpm
C 168,208,255
F 107,142,35

111111
100001
10E001
100001
111111